0 1 2 0 1 20 13 19 2 2 1 1 2 0 2 2 1 1 1
0 1 0 3 0 20 13 19 1 7 12 12 12 8 2 2 2 3 0
0 1 0 2 0 20 13 19 2 10 4 4 4 11 2 0 0 0 1
0 3 0 0 2 20 13 19 2 10 4 4 4 11 1 0 1 0 0
1 1 0 1 0 20 13 19 0 10 4 4 4 11 2 1 0 0 0
0 0 0 0 24 15 13 19 0 5 9 9 9 6 2 2 0 0 2
1 0 2 24 15 13 13 19 2 0 2 1 1 2 2 2 0 0 1
18 18 18 15 13 13 13 14 18 18 18 18 18 18 18 18 18 25 1
13 13 13 13 13 13 13 13 13 13 13 13 13 13 13 13 13 19 1
21 21 21 21 21 17 13 16 21 21 21 21 21 21 21 21 21 23 1
0 0 0 3 0 20 13 19 0 2 0 3 0 0 0 1 0 0 1
0 2 2 0 0 20 13 19 2 0 1 0 1 1 0 0 1 1 1
2 0 0 0 0 20 13 19 0 3 0 0 1 0 0 1 0 0 2
0 1 1 0 2 20 13 19 1 1 0 0 2 0 0 0 0 0 1
0 0 0 2 1 20 13 19 1 0 2 0 0 3 0 0 0 0 2
1 0 1 0 0 20 13 19 0 1 0 0 1 0 0 1 1 1 0
3 0 0 1 1 20 13 19 1 1 0 0 2 2 0 0 1 1 0
1 1 1 0 0 20 13 19 0 1 2 2 1 1 1 0 3 0 0
1 1 2 0 1 20 13 19 2 2 0 1 1 0 2 0 1 1 0
1 0 0 2 3 20 13 19 1 1 2 0 0 0 1 1 0 0 0
0 1 3 1 1 20 13 14 18 18 18 18 18 18 25 1 0 0 1
0 0 1 0 2 20 13 13 13 13 13 13 13 13 19 0 1 1 2
1 1 2 0 1 22 21 21 21 21 21 21 21 21 23 0 3 0 0
2 3 1 0 0 0 1 1 0 0 0 2 2 0 1 0 0 0 1