0 1 0 0 0 0 0 0 0 0 0 0 0 0 0 0
0 1 0 0 0 0 0 3 7 7 7 7 7 7 4 0
0 1 1 1 1 1 0 8 2 2 2 2 2 2 9 0
0 0 0 0 0 1 0 8 2 2 2 2 2 2 9 0
0 0 0 0 0 1 0 8 2 2 2 2 2 2 9 0
0 0 0 0 0 1 0 8 2 2 2 2 2 2 9 0
0 0 0 0 0 1 0 5 10 10 10 10 10 10 6 0
0 0 0 0 0 1 0 0 0 0 0 0 0 0 0 0
0 0 0 0 0 1 1 1 1 1 1 1 1 1 1 1
0 0 0 0 0 1 0 0 0 0 0 0 0 0 0 0
0 0 0 0 0 1 0 0 0 0 0 0 0 0 0 0
0 0 0 0 0 1 0 0 0 0 0 0 0 0 0 0