1 0 0 0 2 2 36 31 0 0 0 0 1 35 2 3 2 1 0 0 1 0 1 2 0 37 20 13 19 2 0 0 0 2 0 2 2 1 31 1 40 2
0 0 0 0 32 0 2 1 32 0 0 0 1 0 0 1 0 0 0 1 2 0 1 0 3 0 20 13 19 32 7 12 12 12 12 12 8 2 33 32 0 0
31 1 0 0 31 0 0 0 31 0 0 0 0 1 0 0 1 0 0 0 0 0 1 0 2 0 20 13 19 2 10 4 4 4 4 4 11 2 0 0 31 1
32 0 37 0 35 2 0 3 0 1 0 0 1 32 1 31 0 0 1 2 0 0 3 0 0 2 20 13 19 2 10 4 30 4 27 4 11 1 0 39 0 0
0 1 33 2 32 0 31 0 31 0 0 32 1 0 0 0 33 0 0 36 1 31 33 0 1 0 20 13 19 0 10 4 26 29 28 4 11 2 1 0 0 0
1 0 0 1 33 36 3 0 0 34 0 32 31 0 39 0 1 0 0 0 0 0 0 0 0 24 15 13 19 0 5 9 9 9 9 9 6 2 35 0 0 2
0 31 1 0 31 0 0 2 33 0 1 0 35 0 0 37 34 0 2 2 1 33 0 2 24 15 13 13 19 2 0 2 1 1 2 31 2 0 0 1 0 0
0 0 0 32 34 0 35 0 24 18 18 18 18 18 18 18 18 18 18 18 18 18 18 18 15 13 13 13 14 18 18 18 18 18 18 18 18 18 25 1 1 1
0 0 1 0 0 32 0 0 20 13 13 13 13 13 13 13 13 13 13 13 13 13 13 13 13 13 13 13 13 13 13 13 13 13 13 13 13 13 19 1 0 0
0 2 0 0 0 0 0 0 22 21 21 21 21 21 21 21 21 21 21 21 21 21 21 21 21 21 17 13 16 21 21 21 21 21 21 21 21 21 23 1 0 2
0 0 34 0 2 0 0 0 0 38 0 0 0 0 0 0 0 1 36 0 31 0 0 0 40 0 20 13 19 0 2 0 3 0 0 0 1 0 0 1 36 0
0 0 0 0 0 33 0 0 2 0 0 0 0 0 1 2 0 0 2 2 0 0 34 2 0 0 20 13 19 2 0 1 0 1 33 0 0 32 31 36 0 31
1 33 0 0 31 0 36 0 1 0 0 0 35 0 0 38 0 7 12 12 12 12 12 8 0 0 20 13 19 0 39 0 0 1 0 0 1 0 0 2 1 1
0 0 0 0 0 0 31 0 3 0 32 0 0 36 0 0 35 10 4 4 4 4 4 11 0 2 20 13 19 33 1 0 0 2 0 0 0 0 31 1 2 38
0 0 0 32 0 0 0 0 35 0 0 34 0 0 3 1 0 10 4 30 4 4 4 11 2 1 20 13 19 32 0 2 0 0 3 37 0 0 0 32 2 3
0 3 0 0 0 0 0 37 0 2 31 0 0 32 36 0 0 10 4 4 26 4 4 11 0 0 20 13 19 0 1 0 0 1 0 0 31 1 33 0 0 0
0 0 0 0 0 0 0 0 0 0 0 0 0 0 0 0 0 10 30 4 4 4 4 11 31 33 20 13 19 1 35 0 0 31 32 0 0 36 32 0 1 0
0 0 0 0 31 0 0 35 0 2 31 0 2 0 31 0 34 10 4 4 4 4 4 11 0 0 20 13 19 0 34 2 34 32 31 0 0 3 0 0 2 2
0 36 0 0 0 0 0 0 38 0 1 24 18 25 0 33 32 10 4 4 4 4 4 11 0 1 20 13 19 2 2 0 1 31 0 2 0 1 33 0 0 1
0 0 0 39 3 0 36 1 0 0 0 20 13 19 31 1 0 10 4 4 4 4 4 11 31 3 20 13 19 33 1 2 0 0 0 32 1 0 0 0 32 0
2 0 35 0 33 0 0 0 40 2 0 20 13 19 2 0 0 10 4 4 4 27 4 11 1 33 20 13 14 18 18 18 18 18 18 25 32 0 0 1 1 1
0 0 0 0 0 0 0 32 0 0 2 20 13 19 0 0 0 10 4 28 4 4 4 11 0 2 20 13 13 13 13 13 13 13 13 19 0 31 1 2 0 1
1 0 0 38 0 34 0 0 2 35 0 20 13 19 0 2 40 5 9 9 9 9 9 6 0 1 22 21 21 21 21 21 21 21 21 23 37 3 0 0 35 2
0 33 0 0 2 0 0 0 0 0 37 20 13 19 0 31 1 0 0 2 2 2 3 0 0 0 0 39 0 0 0 0 2 33 0 1 31 0 0 34 0 38
0 0 37 0 1 0 0 0 0 0 0 20 13 19 1 0 35 2 33 0 0 0 1 0 0 34 1 0 0 0 31 0 0 34 0 0 0 0 1 40 2 0